#
#27
karak_province = {
	700 224 4440 4458 4546 4558 4562 4577 4472 4469 4466 4473 4481 4503 4511 
	4517 4113 4486 4483 4537 4409 4574 4402 4598 686 754 4434 1817
}

chaos_dwarf_karak_province = {
	700 224 4440 4458 4546 4558 4562 4577 4472 4469 4466 4473 4481 4503 4511 
	4517 4506 4486 4483 4537 4409 4574 4402 4598 686 754 4434 810 2721 4258 2206 794
}

johtunheim_gianthome_province = { # Norscan Mountains
	1151 1158 1131 1132 1157 1150 1153 1141 1143 1142 1144 1145 1148 1149 1147
	1136 1159 1138 1137 1139 1140 1156 1155 1154 1152 1119 1126 1129 1123 1130
	1128 1134 1135 1133 1127
}

north_empire_coast_province = { # North Empire Coast, For Norsca Raid Mission
	144 140 130 127 128 209 208
}

mouth_reik_river_province = { # Marienburg and surrounding areas
	90 81 84 79 83 87 89 88 86 85
}

norsca_monolith_province = {
	411 423 395 412 419
}

amazonia_river_coast_province = {
	2368 2375 2377 2378 2379 2456 2455 2454 2453 2452 2288 4221 2395 2382 2380 
	2381 2384 2385 2386 2387 2388 2370 2371 2372 2373
}